あうぉーく	AWOKE	名詞	歌唱:DOLLCHESTRA 2023年03月29日発売 蓮ノ空女学院スクールアイドルクラブ デビューミニアルバム 収録
あうぼーど	Au Bord du Lac	短縮よみ	
あさがおれいじょう	朝顔令嬢	名詞	
あめあがりすとりーと	アメアガリストリート	名詞	
あめとあじさいにうたへば	雨と紫陽花に唄へば	名詞	
いしんでんしん	以心☆電信	名詞	
いっつぁ	@いっつぁどりーみんわーるど！	短縮よみ	
うぃず	With×MEETS	短縮よみ	
うぃずみーつ	With×MEETS	名詞	
うさぴょん	宇宙演舞☆うさぴょん	短縮よみ	
うさぴょん	宇宙警察★うさぴょん	短縮よみ	
うちゅうえんぶ	宇宙演舞☆うさぴょん	短縮よみ	
うちゅうけいさつ	宇宙警察★うさぴょん	短縮よみ	
おうからんまん	謳歌爛漫	名詞	歌唱:スリーズブーケ 2023年06月14日発売 スリーズブーケ＆DOLLCHESTRA ユニットスプリットシングル 収録
おおがみ	大賀美	姓	
おおがみさち	大賀美沙知	人名	
おおさわ	大沢	姓	
おおさわるりの	大沢瑠璃乃	人名	CV:菅叶和
おーろらすかい	オーロラスカイ	名詞	
おくりもの	冬のおくりもの	短縮よみ	
おとむね	乙宗	姓	
おとむねこずえ	乙宗梢	人名	CV:花宮初奈
おんゆあ	On your mark	短縮よみ	歌唱:蓮ノ空女学院スクールアイドルクラブ 2023年03月29日発売 蓮ノ空女学院スクールアイドルクラブ デビューミニアルバム 収録
かほ	花帆	名	
かほめぐ	かほめぐ♡じぇらーと	名詞	日野下花帆・藤島慈によるスペシャルユニット
からふるねす	Colorfulness	名詞	
かるた	蓮ノ空歌留多	名詞	
かわいいのすすめ	Kawaii no susume	名詞	歌唱:スリーズブーケ 2023年08月09日発売 スリーズブーケ 2ndシングル 収録
かん	菅	姓	
かんかんな	菅叶和	人名	大沢瑠璃乃 役
かんな	叶和	名	
きっさ	喫茶ハスノソラ	短縮よみ	
きぼうてき	希望的プリズム	短縮よみ	歌唱:DOLLCHESTRA 2023年04月26日発売 DOLLCHESTRA 1stシングル 収録
きんぎょはなび	金魚◎花火	名詞	
くりすます	Seacret Christmas	短縮よみ	
ぐれいす	Grace Phrase	短縮よみ	
くんぷう	薫風の調べ	短縮よみ	
げいしゅん	迎春 -食-	名詞	
げいしゅん	迎春 -舞-	名詞	
げいしゅん	迎春 -楽-	名詞	
げんようやこう	眩耀夜行	名詞	歌唱:スリーズブーケ 2023年08月09日発売 スリーズブーケ 2ndシングル 収録
こずえ	梢	名	
こっとん	コットン=ユートピア	名詞	
ことこ	琴子	名	
ささき	佐々木	姓	
ささきことこ	佐々木琴子	人名	夕霧綴理 役
さち	沙知	名	
さんくす	Special Thanks	名詞	
しくれ	Seacret Christmas	短縮よみ	
しすか	SIsCa	名詞	
じぶんだいありー	ジブンダイアリー	名詞	歌唱:DOLLCHESTRA 2023年08月09日発売 DOLLCHESTRA 2ndシングル 収録
しゃぼん	青とシャボン	短縮よみ	
すいさいせかい	水彩世界	名詞	歌唱:スリーズブーケ 2023年03月29日発売 蓮ノ空女学院スクールアイドルクラブ デビューミニアルバム 収録
すくこね	スクールアイドルコネクト	短縮よみ	
すくすて	スクールアイドルステージ	短縮よみ	
すけいぷ	スケイプゴート	名詞	歌唱:DOLLCHESTRA 2023年06月14日発売 スリーズブーケ＆DOLLCHESTRA ユニットスプリットシングル 収録
すぱすぽ	Sparkly Spot	短縮よみ	歌唱:DOLLCHESTRA 2023年04月26日発売 DOLLCHESTRA 1stシングル 収録
すぷらっしゅ	SPLASH!!!!	名詞	
すりぶ	スリブ	短縮よみ	
すりぶ	スリーズブーケ	短縮よみ	
すりぶ	Cerise Bouquet	短縮よみ	
せつぶん	節分 -魅-	名詞	
せつぶん	節分 -妖- 	名詞	
せつぶん	節分 -艶-	名詞	
せんぺんばんか	千変万華	名詞	
ちぇりーぴくにっく	チェリー♫ピクニック	名詞	
つきね	月音	姓	
つきねこな	月音こな	人名	藤島慈 役
つきまかせ	ツキマカセ	名詞	歌唱:DOLLCHESTRA 2023年04月26日発売 DOLLCHESTRA 1stシングル 収録
つづり	綴理	名	
つばさ	ツバサ・ラ・リベルテ	名詞	
でぃーぷねす	DEEPNESS	名詞	歌唱:蓮ノ空女学院スクールアイドルクラブ 2023年08月09日発売 スリーズブーケ 2ndシングル/DOLLCHESTRA 2ndシングル 収録
とうせつめいき	桃節銘記	名詞	
どどど	ド！ド！ド！	名詞	歌唱:みらくらぱーく！ 2023年03月29日発売 蓮ノ空女学院スクールアイドルクラブ デビューミニアルバム 収録
とらじっく	Tragic Drops	短縮よみ	歌唱:DOLLCHESTRA 2023年06月14日発売 スリーズブーケ＆DOLLCHESTRA ユニットスプリットシングル 収録
とりき	Trick & Cute	短縮よみ	
とりっく	Trick & Cute	短縮よみ	
どりびり	Dream Believers	短縮よみ	歌唱:蓮ノ空女学院スクールアイドルクラブ 2023年03月29日発売 蓮ノ空女学院スクールアイドルクラブ デビューミニアルバム 収録
どるけ	ドルケ	短縮よみ	
どるけ	DOLLCHESTRA	短縮よみ	
どるけ	ドルケストラ	短縮よみ	
どるふぃんびーち	ドルフィン～ビーチ	名詞	
なつめき	夏めきペイン	短縮よみ	
にいな	初奈	名	
にれい	楡井	姓	
にれいのぞみ	楡井希実	人名	日野下花帆 役
のぞみ	希実	名	
のっと	KNOT	名詞	
のなか	野中	姓	
のなかここな	野中ここな	人名	村野さやか 役
はくちゅー	ハクチューアラモード	短縮よみ	
はじける	はじける☆オレンジソーダ	短縮よみ	
はじける	はじける☆ブルーソーダ	短縮よみ	
はじける	はじける☆メロンソーダ	短縮よみ	
はじける	はじける☆スイカソーダ	短縮よみ	
はすのきゅうじつ	蓮ノ休日	名詞	村野さやか・乙宗梢によるスペシャルユニット
はすのそら	蓮ノ空	名詞	
はすのそら	蓮ノ空女学院	名詞	
はすのそら	蓮ノ空女学院スクールアイドルクラブ	名詞	
はっぴーしじょうしゅぎ	ハッピー至上主義！	名詞	
はなこんじょう	華紺青	名詞	
はなみや	花宮	姓	
はなみやにいな	花宮初奈	人名	乙宗梢 役
はるいろにゅーでいず	春色ニューデイズ	名詞	
ひのした	日野下	姓	
ひのしたかほ	日野下花帆	人名	CV:楡井希実
びびっど	Vivid Phrase	名詞	
ふぇす	Fes×LIVE	短縮よみ	
ふぇすらいぶ	Fes×LIVE	名詞	
ふぉーちゅん	フォーチュンムービー	名詞	歌唱:スリーズブーケ 2023年04月26日発売 スリーズブーケ 1stシングル 収録
ふじしま	藤島	姓	
ふじしまめぐみ	藤島慈	人名	CV:月音こな
ぶとうかい	奇跡の舞踏会	短縮よみ	
ぶとうかい	革命の舞踏会	短縮よみ	
ぶとうかい	約束の舞踏会	短縮よみ	
ぷりずむえこー	Prism Echo	名詞	
ぷれじゃー	Presure Feather	短縮よみ	
ぺんぎんあいす	ペンギンアイス	名詞	
ほりほり	Holiday∞Holiday	品詞なし	歌唱:スリーズブーケ 2023年06月14日発売 スリーズブーケ＆DOLLCHESTRA ユニットスプリットシングル 収録
みっくすしぇいく	Mix shake!!	名詞	歌唱:スリーズブーケ 2023年04月26日発売 スリーズブーケ 1stシングル 収録
みらぱ	みらくらぱーく！	名詞	
みらぼや	Mirage Voyage	短縮よみ	歌唱:DOLLCHESTRA 2023年08月09日発売 DOLLCHESTRA 2ndシングル 収録
むらの	村野	姓	
むらのさやか	村野さやか	人名	CV:野中ここな
めぐみ	慈	名	
ゆあーず	your ever	短縮よみ	
ゆうぎり	夕霧	姓	
ゆうぎりつづり	夕霧綴理	人名	CV:佐々木琴子
ゆーふぉ	永遠のEuphoria	短縮よみ	歌唱:蓮ノ空女学院スクールアイドルクラブ 2023年03月29日発売 蓮ノ空女学院スクールアイドルクラブ デビューミニアルバム 収録
ゆのくに	ゆのくにガールズ！	短縮よみ	
らきとれ	lucky train!	短縮よみ	
りふれくしょん	Reflection in the mirror	短縮よみ	歌唱:スリーズブーケ 2023年04月26日発売 スリーズブーケ 1stシングル 収録
りんく	Link to the FUTURE	短縮よみ	
りんくら	Link! Like! ラブライブ!	短縮よみ	
るりの	瑠璃乃	名	
るりのとゆかいなつづりたち	るりのとゆかいなつづりたち	名詞	大沢瑠璃乃・夕霧綴理によるスペシャルユニット
ろーずがーでん	Rose Garden	名詞	
わんでい	R's One Day	短縮よみ	
わんでい	M's One Day	短縮よみ	
れんげさい	蓮華祭	名詞	
りんどうさい	竜胆祭	名詞	
なでしこさい	撫子祭	名詞	
